1001111111011
10010000F00C011
1G000111110001
1P0011E00M001111
1100111111111
