1111111111111111111111111111111111
1E0000000000000C00000C010000000001
10100101001000P0101001010000010101
1010010010101010001001010000010101
100000000C00C0000000000100000000C1
1111111111111111111111111111111111