1111111111111
10010000000C1
10B00111110B1
1P0B11E000001
100000000B001
1111111111111
