111111111
100PC0111
1000E1101
1000C0001
111111111